00000000000000000000000000000000
00000000010100000110111111111011
00000000001001101010000010011110
00000000000101111111001000011000
00000000000100000000000000000000
00000000000010101011000011011100
00000000000001101010000010011110
00000000000000110010111010111110
00000000000000000000000000000000
11111111111111001101000101000001
11111111111110010101111101100001
11111111111101010100111100100011
11111111111100000000000000000000
11111111111010000000110111100111
11111111110110010101111101100001
11111111101011111001000000000100
00000000000000000000000000000000
00000000010100000110111111111011
00000000001001101010000010011110
00000000000101111111001000011000
00000000000100000000000000000000
00000000000010101011000011011100
00000000000001101010000010011110
00000000000000110010111010111110
00000000000000000000000000000000
11111111111111001101000101000001
11111111111110010101111101100001
11111111111101010100111100100011
11111111111100000000000000000000
11111111111010000000110111100111
11111111110110010101111101100001
11111111101011111001000000000100