00000000000100000000000000000000
11111111111100000000000000000000
00000000001000000000000000000000
11111111111100000000000000000000
00000000000110000000000000000000
11111111111100000000000000000000
00000000001010000000000000000000
11111111111100000000000000000000
00000000000101000000000000000000
11111111111100000000000000000000
00000000001001000000000000000000
11111111111100000000000000000000
00000000000111000000000000000000
11111111111100000000000000000000
00000000001011000000000000000000
11111111111100000000000000000000
00000000000100100000000000000000
11111111111100000000000000000000
00000000001000100000000000000000
11111111111100000000000000000000
00000000000110100000000000000000
11111111111100000000000000000000
00000000001010100000000000000000
11111111111100000000000000000000
00000000000101100000000000000000
11111111111100000000000000000000
00000000001001100000000000000000
11111111111100000000000000000000
00000000000111100000000000000000
11111111111100000000000000000000
00000000001011100000000000000000
11111111111100000000000000000000