00000000000000000000000000000000
00000000000100000000000000000000
00000000000000000000000000000000
11111111111100000000000000000000
00000000000000000000000000000000
00000000000100000000000000000000
00000000000000000000000000000000
11111111111100000000000000000000
00000000000000000000000000000000
00000000000100000000000000000000
00000000000000000000000000000000
11111111111100000000000000000000
00000000000000000000000000000000
00000000000100000000000000000000
00000000000000000000000000000000
11111111111100000000000000000000
00000000000000000000000000000000
00000000000100000000000000000000
00000000000000000000000000000000
11111111111100000000000000000000
00000000000000000000000000000000
00000000000100000000000000000000
00000000000000000000000000000000
11111111111100000000000000000000
00000000000000000000000000000000
00000000000100000000000000000000
00000000000000000000000000000000
11111111111100000000000000000000
00000000000000000000000000000000
00000000000100000000000000000000
00000000000000000000000000000000
11111111111100000000000000000000