00000000000000000000000000000000
00000000101000100111001101100010
00000000010100000110111111111011
00000000001101001011111010110011
00000000001001101010000010011110
00000000000111011110111100010011
00000000000101111111001000011000
00000000000100110111111011111101
00000000000100000000000000000000
00000000000011010010000110000000
00000000000010101011000011011100
00000000000010001000110101011011
00000000000001101010000010011110
00000000000001001101101010000010
00000000000000110010111010111110
00000000000000011001001101101011
00000000000000000000000000000000
11111111111111100110110010010100
11111111111111001101000101000001
11111111111110110010010101111101
11111111111110010101111101100001
11111111111101110111001010100100
11111111111101010100111100100011
11111111111100101101111001111111
11111111111100000000000000000000
11111111111011001000000100000010
11111111111010000000110111100111
11111111111000100001000011101100
11111111110110010101111101100001
11111111110010110100000101001100
11111111101011111001000000000100
11111111010111011000110010011101