00000000000000000000000000000000
00000000001001101010000010011110
00000000000100000000000000000000
00000000000001101010000010011110
00000000000000000000000000000000
11111111111110010101111101100001
11111111111100000000000000000000
11111111110110010101111101100001
00000000000000000000000000000000
00000000001001101010000010011110
00000000000100000000000000000000
00000000000001101010000010011110
00000000000000000000000000000000
11111111111110010101111101100001
11111111111100000000000000000000
11111111110110010101111101100001
00000000000000000000000000000000
00000000001001101010000010011110
00000000000100000000000000000000
00000000000001101010000010011110
00000000000000000000000000000000
11111111111110010101111101100001
11111111111100000000000000000000
11111111110110010101111101100001
00000000000000000000000000000000
00000000001001101010000010011110
00000000000100000000000000000000
00000000000001101010000010011110
00000000000000000000000000000000
11111111111110010101111101100001
11111111111100000000000000000000
11111111110110010101111101100001