00000000111100000000000000000000
11111111111100000000000000000000
11111111111100000000000000000000
11111111111011111111111111111111
11111111111100000000000000000000
11111111111100000000000000000000
11111111111100000000000000000000
11111111111011111111111111111111
11111111111100000000000000000000
11111111111100000000000000000000
11111111111100000000000000000000
11111111111100000000000000000000
11111111111100000000000000000000
11111111111100000000000000000000
11111111111100000000000000000000
11111111111100000000000000000000
00000001000000000000000000000000
11111111111100000000000000000000
11111111111100000000000000000000
11111111111011111111111111111111
11111111111100000000000000000000
11111111111100000000000000000000
11111111111100000000000000000000
11111111111011111111111111111111
11111111111100000000000000000000
11111111111100000000000000000000
11111111111100000000000000000000
11111111111100000000000000000000
11111111111100000000000000000000
11111111111100000000000000000000
11111111111100000000000000000000
11111111111100000000000000000000