00000000001100000000000000000000
11111111111100000000000000000000
11111111111100000000000000000000
11111111111100000000000000000000
00000000010000000000000000000000
11111111111100000000000000000000
11111111111100000000000000000000
11111111111100000000000000000000
00000000001110000000000000000000
11111111111100000000000000000000
11111111111100000000000000000000
11111111111100000000000000000000
00000000010010000000000000000000
11111111111100000000000000000000
11111111111100000000000000000000
11111111111100000000000000000000
00000000001101000000000000000000
11111111111100000000000000000000
11111111111100000000000000000000
11111111111100000000000000000000
00000000010001000000000000000000
11111111111100000000000000000000
11111111111100000000000000000000
11111111111100000000000000000000
00000000001111000000000000000000
11111111111100000000000000000000
11111111111100000000000000000000
11111111111100000000000000000000
00000000010011000000000000000000
11111111111100000000000000000000
11111111111100000000000000000000
11111111111100000000000000000000